5 5 5 5 5 5 5 5 5 5 5 5 5 5 5 5
5 0 0 0 0 0 0 0 0 0 0 0 0 0 0 5
5 0 0 0 0 1 0 0 0 0 0 0 1 0 0 5
5 0 0 0 0 0 0 0 0 0 0 0 0 0 0 5
5 0 1 0 0 0 0 0 0 0 0 0 0 0 0 5
5 0 0 0 0 0 0 0 0 0 1 0 0 0 0 0
5 0 0 0 0 0 1 0 0 0 0 0 0 0 0 0
0 0 0 0 3 3 3 0 0 0 0 0 0 0 0 5
0 0 0 0 3 0 3 3 0 0 0 0 0 0 0 5
5 3 3 3 3 0 0 3 0 0 0 0 0 0 0 5
5 3 3 3 0 0 1 3 0 0 0 0 0 0 0 5
5 5 5 5 5 5 5 5 5 5 5 5 5 5 5 5